11111111111111111111111111111
1C001C00001C1C000000C101000C1
10101011001010111111010001111
10001001101000000000011010001
10101000000011110111110000111
100011101110001001000001000C1
11000C10000000000001111C11001
1C011010011111101000000001011
1000001000001C10C011100111001
101100001110001000001011C1101
10010010010000001001100001001
110001C10101011011001101110E1
1P00000000000000C0000000C0001
11111111111111111111111111111