111111111111111111111111111111111
1000000000000000000000000000000E1
101C101C101C101C101C101C101C10101
101010101010101010101010101010101
101010101010101010101010101010101
101010101010101010101010101010101
101010101010101010101010101010101
10000C000C000C000C000C000C000C001
101C101C101C101C101C101C101C10101
101010101010101010101010101010101
101010101010101010101010101010101
101010101010101010101010101010101
101010101010101010101010101010101
1P000C000C000C000C000C000C000C001
111111111111111111111111111111111