1111111111111111111111111111111
1000000000010000010000000000001
1011101111010101010111101110001
1000000001000000000100000000001
1111011101011111110101110111001
1000000101000000000101000000001
1011110101001010100101011110001
1000010100001000100001010000001
1111010101001111100101010111001
1001000001000010000100000100001
1111011111001111100111110111001
1001000100011010110001000100001
1P000100010C00000001000100010E1
1111111111111111111111111111111